xxxxxxxxxxxxxxxx
x              x
x Q            x
x{-}           x
x[#]           x
x[#]           x
xxxxxxxxxxxx   x
x              x
x              x
x              x
x              x
x          FFF x
x              x
x      H    M  x
x     xxxxxxxxxx
x              x
x              x
x              x
x              x
x          @   x
x    xxxxxxxxxxx
x              x
x              x
x              x
x  \obbo/      x
x   \oo/       x
xxxxxxxxxxxxxxxx