xxxxxxxxxxxxxxxx
x              x
x Q            x
x{-}           x
x[#]           x
x[#]    C      x
xxxxxxxxxxxx   x
x              x
x              x
x              x
x              x
x      e E e f x
x     xxxxxxxxxx
x              x
x              x
x              x
x              x
x              x
x              x
x              x
x          @   x
x    xxxxxxxxxxx
x              x
x              x
x              x
x  \oooo/      x
x   \oo/       x
xxxxxxxxxxxxxxxx