xxxxxxxxxxxxxxxx
x              x
x              x
x              x
x              x
x              x
x              x
x              x
x              x
x              x
x       C   C  x
x     xxxxxxxxxx
x              x
x              x
x              x
x              x
x              x
x              x
x              x
x          @   x
x    xxxxxxxxxxx
x              x
x              x
x              x
x  \oooo/      x
x   \oo/       x
xxxxxxxxxxxxxxxx