xxxxxxxxxxxxxxxxxxxxxxxxx
x           x           x
x           x           x
x           x        Q  x
x           x       {-} x
x           x       [#] x
x           x       [#] x
x           x    xxxxxxxx
x           x           x
x\oo/ @                 x
xxxxxxxxxxxxxxxxxxxxxxxxx