xxxxxxxxxxxxxxxxxxxxxxx
x                     x
x Q                   x
x{-}                  x
x[#]                  x
x[#]                  x
xxxxx                 x
x                     x
x                     x
x                     x
x                     x
x                     x
x                     x
x                     x
x      8              x
x                     x
x      @              x
xxxxxxxxx     xxxxxxxxx
x                     x
x                     x
xr  r   r   r     r   x
xxxxxxxxxxxxxxxxxxxxxxx