xxxxxxxxxxxxxxxx
x              x
x Q            x
x{-}           x
x[#]           x
x[#]           x
xxxxx          x
x              x
x              x
x      8       x
x              x
x      @       x
x     xxx      x
x              x
x              x
xr  r H r   r  x
xxxxxxxxxxxxxxxx