xxxxxxxxxxxxxx
x            x
x         Q  x
x        {-} x
x        [#] x
x        [#] x
x      xxxxxxx
x            x
x            x
x            x
x            x
x            x
x            x
x            x
x            x
x            x
x            x
x            x
x F          x
x            x
xB H H e     x
xxxxxxxxx    x
x            x
x            x
x            x
x            x
x            x
xfefE @ B  C x
xxxxxxxxxxxxxx