xxxxxxxxxxxxxx
x            x
x         Q  x
x        {-} x
x        [#] x
x        [#] x
x      xxxxxxx
x            x
x            x
x            x
x            x
x            x
x            x
x            x
x            x
x H  H       x
xxxxxxxxx    x
x            x
x            x
x            x
x            x
x            x
xffff @ B  C x
xxxxxxxxxxxxxx