xxxxxxxxxxxxxxxx
x              x
x              x
x              x
x              x
x              x
x              x
x              x
x          @   x
x    xxxxxxxxxxx
x              x
x              x
x              x
x    oo        x
x   oooo       x
xxxxxxxxxxxxxxxx